666666666-
666666666-
644444947-
688888587-
680418587-
685858587-
685858587-
685858587-
809494377-
858858877-
858858877-
824494447-
688858887-
666888666-
666666666-
666666666